R  100 100
NO ./textures/mandatory/bluestone.xpm
SO ./textures/mandatory/mossy.xpm
WE ./textures/mandatory/redbrick.xpm
EA ./textures/mandatory/colorstone.xpm
S ./textures/mandatory/pillar.xpm
SS  ./textures/bonus/ammo.xpm
EN ./textures/bonus/enemy1.xpm
C  127,127,127
F  255,0,0

111111111111111111111
101000100000000000001
101010100000000000001
101010500000000000001
101010100000000000001
10001090000N000000001
111510100000000000001
100000000000000000001
100000001000000000001
100000000100000000001
100000000000000000001
100000000004000000001
100000000000000000001
100000000004000000001
100000000004000000001
100000040000040004001
100000000000000000001
111111111111111111111


