R 1280 720

NO ./textures/bluestone.xpm
SO ./textures/mossy.xpm
WE ./textures/redbrick.xpm
EA ./textures/colorstone.xpm
S ./textures/pillar.xpm
F  240,0,120
C  0,96,0


1111111111111111111111111111111111111111111111111111111111111
1000000000010000000000000000000000000000000000000000000000001
1000N00001010111111111111111111111111111111111111111111111101
1000000001010100000000000000000000000000000000000000000000001
1011111111010111111111111111111111111111111111111111111111101
1000000000010100000000000000000000000000000000000000000000001
1111111111000101111111111111111111111111111111111111111111111
10000000000001000000000000000000000000000000000000000000000 1
1111111111111111111111111111111111111111111111111111111111111